#############################################################################################
# . . . . . . . . . . . . . . . . . . . . . . . . . . . . . . . . . . . . . . . . . . . . . #
# .   ########### .                 #################                    ########### . . .  #
# .   #         # . .               #               #                    #         # . . .  #
# .   #         # .                 #               #                    #         # . . .  #
# .   ########### .                 #################                    ########### . . .  #
#                                                                                           #
#                                                                                           #
###############                     ######      #####                        ################
              #                     #               #                        #
              #                     #               #                        #
###############                     #################                        ################
# . . . . . . . . . . . . . . . . . . . . . . . . . . . . . . . . . . . . . . . . . . . . . #
#                                                                                           #
                                   ##################
                                           #
#                                          #     H                                          #
# . . . . . . . . . . . . . . . . . . . . .#. . . . . . . . . . . . . . . . . . . . . . . . #
######                                     #                                           ######
#    #                                     #                                           #    #
# .  #                                                                                 #    #
# .  ###########                                                             ###########    #
# . . . . . . . . . . . . . . . . . . . . . . . . . . . . . . . . . . . . . . . . . . . . . #
#############################################################################################
